WWWWW.UUU.WWWWWB.............................
W..CBT...T....WB.............................
WBBDB......V..WB.............................
W..........S..WB.............................
LT......B.....TRB............................
L......1B......RB............................
LT......B.....TRB............................
W......S......W.B............................
W.............W.B............................
WWWWWWWWWWWWWWW.B............................