....B.....B....B.............................
....B.....B....B.............................
....B.....B....B.............................
BBBBB.....BBBBBB.............................
L...............B............................
L......1........B............................
BBBBB.....BBBBBBB............................
....B.....B.....B............................
....B.....B.....B............................
....B.....B.....B............................