WWWWWUUUUUWWWWWB.............................
W.C.BT...T....WB.............................
W...B..V......WB.............................
WBDDB......S..WB.............................
LT......B.....TRB............................
L......1B......RB............................
LT......B.....TRB............................
W......S......W.B............................
W......S......W.B............................
WWWWWWWWWWWWWWW.B............................