WWWWWWWWWWWWWWWB.............................
W......E......WB.............................
W..C.......C..WB.............................
WDDDDDDDDDDDDDWB.............................
L..............RB............................
L......1.......RB............................
L..............RB............................
W...B..S..B...W.B............................
W...BT...TB...W.B............................
WWWWW.AAA.WWWWW.B............................