WWWWWWWWWWWWWWWB.............................
W...E..B..E...WB.............................
W..C...B...C..WB.............................
WDDDDDDDDDDDDDWB.............................
L........D.....RB............................
L......1.D..E..RB............................
L........D.....RB............................
WBBBBS...SBBBBWB............................
WBBBBT...TBBBBWBB............................
WWWWW.AAA.WWWWW.B............................