WWWWWUUUUUWWWWWB.............................
W............EWB.............................
W..B..........WB.............................
WBBBBBBBBBBB..WB.............................
LT............WB.............................
L.....1.......WB.............................
LT..S.........WB.............................
W...BBBBBBBBBBWB.............................
W............EWB.............................
WWWWWWWWWWWWWWWWB............................