WWWWW.UUU.WWWWWB.............................
W............EWB.............................
W..B..........WB.............................
WBBBBBBBBBBB..WB.............................
LT.............WB............................
L.....1........WB............................
LT..S..........WB............................
W...BBBBBBBBBBBWB............................
W............E.WB............................
WWWWWWWWWWWWWWWWB............................