WWWWWWWWWWWWWWWB.............................
W.............WB.............................
W.....1.......WB.............................
W.....S....S..WB.............................
L....BBBBB... WB.............................
L....B.C.B....W.B............................
L....B...B....W.B............................
W..V.BDDDB..V.W.B............................
W..S.......S..W.B............................
WWWWWWWWWWWWWWW.B............................