WWWWWWWWWWWWWWWB.............................
W.....S.......WB.............................
W.....1.......WB.............................
W.............WB.............................
L....BBBBB....WB.............................
L....B.C.B....W.B............................
L....B...B....W.B............................
W..V.BDDDB..V.W.B............................
W.............W.B............................
WWWWWWWWWWWWWWW.B............................