WWWWWWUUUUWWWWWB.............................
W.............WB.............................
W....V........WB.............................
W.............WB.............................
W..........V...B............................
W......1.D.....RB............................
W..............RB............................
W...C..PVC....W.B............................
W.............W.B............................
WWWWWWWWWWWWWWW.B............................