WWWWWWUUUUWWWWWB.............................
W.............WB.............................
W....V........WB.............................
W.............WB.............................
W..........V..WB............................
W......1.D....WRB............................
W.............WRB............................
W...C..PVC....W.B............................
W.............W.B............................
WWWWWWWWWWWWWWW.B............................