WWWWWWUUUUWWWWW..............................
W.............W..............................
W....V........W..............................
W.............W..............................
W......N...V..W.............................
W......1.D....W..............................
W.............W..............................
W...CB... BC..W..............................
W....B....B...W..............................
WWWWWWWWWWWWWWW..............................