....B.....B....B.............................
....B.....B....B.............................
....B.....B....B.............................
BBBBB.....BBBBBB.............................
...............RB............................
........1......RB............................
BBBBB.....BBBBBBB............................
....B.....B.....B............................
....B.....B.....B............................
....B.....B.....B............................