WWWWW.UUU.WWWWWB.............................
W.C.BT...TB.P.WB.............................
W...B.V..WBDDDWB.............................
WBBDB......S..WB.............................
LT......B.....TRB............................
L......1B......RB............................
LT......B.....TRB............................
W......S......W.B............................
W.......B.....W.B............................
WWWWWWWWWWWWWWW.B............................