WWWWW.UUU.WWWWWB.............................
W.C.BT...T....WB.............................
W...B.V..WB.............................
WBBDB......S..WB.............................
LT......B.....TRB............................
L......1B......RB............................
LT......B.....TRB............................
W......S......W.B............................
W.............W.B............................
WWWWWWWWWWWWWWW.B............................