WWWWWWWWWWWWWWWB.............................
W...E..B..E..WB.............................
W..C...B...C..WB.............................
WDDDDDDDDDDDDDWB.............................
L..............RB............................
L......1.......RB............................
L..............RB............................
WBBBB..S..BBBBW.B............................
WBBBBT...TBBBBW.B............................
WWWWWWAAAWWWWWW.B............................