WWWWWUUUUUWWWWWB.............................
W............EWB.............................
W..B..........WB.............................
W..BBBBBBBBBBBWB.............................
W.............TRB............................
W.....1........RB............................
W...S.........TRB............................
W...BBBBBBBBBBW.B............................
W............EW.B............................
WWWWWWWWWWWWWWW.B............................