WWWWWWWWWWWWWWWB.............................
W.............WB.............................
W.....1.......WB.............................
W.....S.......WB.............................
W....BBBBB....RWB............................
W....B.C.B....R.B............................
W....B...B....R.B............................
W..V.BDDDB..V.W.B............................
W.............W.B............................
WWWWWWWWWWWWWWW.B............................