WWWWW.UUU.WWWWWB.............................
W.C.B.T.T.B.P.WB.............................
WT.TB.....BT.TWB.............................
WT.TB..S..BT.TWB.............................
WTVTB.E...BTVTWB............................
WT.TB..1..BT.TWB............................
WT.TB..S..BT.TWB............................
WT.TB.....BT.TW.B............................
WT.TD.T.T.DT.TW.B............................
WWWWW.AAA.WWWWW.B............................