....B.....B....B.............................
....B.....B....B.............................
....B.....B....B.............................
BBBBB.....BBBBBB.............................
................B............................
......1.........B............................
BBBBB.....BBBBBBB............................
....B.....B.....B............................
....B.....B.....B............................
....BAAAAAB.....B............................