WWWWW.UUU.WWWWWB.............................
W.ECB.T.T.B.E.WB.............................
W...B.....B...WB.............................
WDDDB.....BBBBWB.............................
LT....S.......TRB............................
L.....S1.......RB............................
LT....S.......TRB............................
WDDDB.....BBBBW.B............................
W.SPB.T.T.BBBBW.B............................
WWWWW.AAA.WWWWW.B............................