WWWWW.UUU.WWWWWB.............................
W.EVD.T.T.D.VEWB.............................
W...D.....D...WB.............................
W...D.....D...WB.............................
W...D.....D..CwB............................
W.P.D-T1T.D...WB............................
W...D.....D...wB............................
WBBBB.....BBBBW.B............................
WBBBB.T.T.BBBBW.B............................
WWWWW.AAA.WWWWW.B............................