WWWWW.UUU.WWWWWB.............................
WBBBB.T.T.BBBBWB.............................
WBBBBST.TSBBBBWB.............................
WBBBB.T.T.BBBBWB.............................
W...D.T.T.D..CWB.............................
W.P.D.S1S.D...WB.............................
W...D.T.T.D...WB.............................
WBBBBST.TSBBBBW.B............................
W...B.T.T.B...W.B............................
WWWWW.AAA.WWWWW.B............................