WWWWWWWWWWWWWWW..............................
W.............W..............................
W....V........W..............................
W.............W..............................
L..........V..W..............................
L..R...1......W..............................
L....C....C...W..............................
W....B...B....W..............................
W....B.N.B....W..............................
WWWWWWWWWWWWWWW..............................