WWWWWWWWWWWWWWW..............................
W...V....V....W..............................
W.............W..............................
W........V....W..............................
L...V.........W..............................
L......1.V....W..............................
L...VC........W..............................
WC..B....B...CW..............................
W...B.N..B....W..............................
WWWWWWWWWWWWWWW..............................