WWWWWWWWWWWWWWWB.............................
W.............WB.............................
W....V........WB.............................
W.............WB.............................
L..........V..WB............................
L......1.D....WRB............................
L.............WRB............................
W.......V.....W.B............................
W.............W.B............................
WWWWWWWWWWWWWWW.B............................