WWWWW.UUU.WWWWWB.............................
W...B.T.T.B...WB.............................
W...B.....B...WB.............................
WBBBB.....BBBBWB.............................
LT..D.S..D....TRB............................
L.....1.......RB.............................
LT............TRB............................
WBBBB.....BBBBW.B............................
W...B.T.T.B...W.B............................
WWWWW.AAA.WWWWW.B............................