....B.UUU.B....B.............................
....B.....B....B.............................
....B.....B....B.............................
BBBBB.....BBBBBB.............................
L....C.........RB............................
L......1.......RB............................
BBBBB.....BBBBBBB............................
....B.....B.....B............................
....B.....B.....B............................
....B.AAA.B.....B............................