WWWWWWWWWWWWWWW..............................
W.............W..............................
W.....F.......W..............................
W.............W..............................
W.............W..............................
W.............W..............................
W.............W..............................
W.............W..............................
W.....1.......W..............................
WWWWWWWWWWWWWWW..............................