WWWWWWWWWWWWWWW..............................
W.............W..............................
W....V........W..............................
W.............W..............................
W..........V..W.............................
W......1......W..............................
W.............W..............................
W...CB...BC...W..............................
W....B.N.B....W..............................
WWWWWAAAAWWWWWW..............................