WWWWWWWWWWWWWWW..............................
W.............W..............................
W....V.N......W..............................
W.............W..............................
W..........V..W.............................
W......1......W..............................
W.............W..............................
W...CB...BC...W..............................
W....B...B....W..............................
WWWWWAAAAWWWWWW..............................