WWWWWUUUUUWWWWWB.............................
W....T1..T....WB.............................
W...S.....S...WB.............................
W.........S...WB.............................
WBBBDDDDDDBBBBWB.............................
WE.P......E..EW.B............................
WBBBBDDDDDBBBBW.B............................
W....S........W.B............................
W....T...T....W.B............................
WWWWWAAAAAWWWWW.B............................