WWWWWUUUUUWWWWWB.............................
W....T...T....WB.............................
W...S.1...S...WB.............................
W.........S...WB.............................
WBBBDDDDDDBBBBWB.............................
WE.P......E..EW.B............................
WBBBBDDDDDBBBBW.B............................
W....S........W.B............................
W....T...T....W.B............................
WWWWWAAAAAWWWWW.B............................