....B.UUU.B....B.............................
....B.....B....B.............................
....B.....B....B.............................
BBBBB.....BBBBBB.............................
......1.........B............................
................B............................
BBBBB.....BBBBBBB............................
....B.....B.....B............................
....B.....B.....B............................
....B.....B.....B............................