WWWWWUUUUUWWWWWB.............................
W....T...T....WB.............................
W....S.1..S...WB.............................
W....S....S...WB.............................
WV...BBBBB.V..WB.............................
W....B.C.B....W.B............................
W....B...B....W.B............................
W..V.BDDDB..V.W.B............................
W....T...T....W.B............................
WWWWWAAAAAWWWWW.B............................