WWWWWUUUUUWWWWWB.............................
W....T...T....WB.............................
W....S1...S...WB.............................
W.............WB.............................
W....BBBBB....WB.............................
W....B.C.B....W.B............................
W....B...B....W.B............................
W..V.BDDDB..V.W.B............................
W....T...T....W.B............................
WWWWWAAAAAWWWWW.B............................