....B.UUU.B....B.............................
....BT...TB....B.............................
....BDDDDDB....B.............................
BBBBB.....BBBBBB.............................
......1...D.SC..B............................
...E......D..S.B.............................
BBBBB.....BBBBBBB............................
....B.VVV.B.....B............................
....BT...TB.....B............................
....BAAAAAB.....B............................