WWWWBUUUUUBWWWWWW............................
W...BT...TB....BW............................
W...BDDDDDB....BW............................
WBBBB.....BBBBBBW............................
W.S...1...D..C..W............................
W..E......D..S.BW............................
WBBBB.....BBBBBBW............................
W...B.VVV.B.....W............................
W...BT...TB.....W............................
WWWWBAAAAABWWWWWW............................